21 21 21 21 21 21 21 21 21 21 21 21 21 21 21 21 21 21 21 21 21 21 1 1 1 21 21 21 21 21 21 21 21 21 21 21 21 21 21 21 21 21 21 21 21 21 21 21 21 21 
21 21 21 21 21 21 21 21 21 21 21 21 21 21 21 21 21 21 21 21 21 21 1 1 1 21 21 21 21 21 21 21 21 21 21 21 21 21 21 21 21 21 21 21 21 21 21 21 21 21 
21 21 21 21 21 31 29 29 29 29 29 29 29 29 29 29 29 29 29 29 29 29 1 1 1 29 29 29 29 29 29 29 29 29 29 29 29 29 29 29 29 29 29 29 29 32 21 21 21 21 
21 21 21 21 21 27 20 20 20 20 20 20 20 20 20 20 20 20 20 20 20 20 2 2 2 20 20 20 20 20 20 20 20 20 20 20 20 20 20 20 20 20 20 20 20 26 21 21 21 21 
21 21 21 21 21 27 20 19 19 19 19 19 19 19 19 19 19 19 19 19 19 20 2 2 2 20 2 2 19 19 2 2 2 19 19 19 19 19 19 19 2 19 19 19 20 26 21 21 21 21 
21 21 21 21 21 27 20 19 19 19 19 19 19 19 19 19 19 19 19 19 19 20 20 2 20 20 2 19 19 2 2 19 2 19 19 2 2 2 2 2 2 19 19 19 20 26 21 21 21 21 
21 21 21 21 21 27 20 19 19 19 19 19 19 19 19 19 19 19 19 19 19 19 2 2 2 19 2 19 2 19 2 19 2 19 19 2 2 23 24 24 25 19 19 19 20 26 21 21 21 21 
21 21 21 21 21 27 20 19 19 19 19 19 19 19 19 19 19 19 19 19 19 19 2 2 2 19 2 19 2 19 2 19 2 19 19 2 2 28 32 31 30 19 19 19 20 26 21 21 21 21 
21 21 21 21 21 27 20 19 19 19 19 19 19 19 19 19 19 19 19 19 19 19 2 2 2 19 2 19 2 2 2 19 19 19 19 19 2 2 28 30 19 19 19 19 20 26 21 21 21 21 
21 21 21 21 21 27 20 19 19 19 19 19 19 19 19 19 19 19 19 19 19 2 2 2 2 19 2 2 2 19 2 2 2 19 19 19 2 2 2 2 2 19 19 19 20 26 21 21 21 21 
21 21 21 21 21 27 20 19 19 19 19 19 19 19 19 19 19 19 19 19 2 2 2 2 2 19 19 2 19 19 19 19 2 19 19 19 19 19 2 19 19 19 19 19 20 26 21 21 21 21 
21 21 21 21 21 27 20 19 19 19 19 19 19 19 19 19 19 19 19 19 2 2 2 19 19 19 2 2 19 2 2 19 2 19 19 19 19 19 2 19 19 19 19 19 20 26 21 21 21 21 
21 21 21 21 21 27 20 19 19 19 19 19 19 19 19 19 19 19 19 19 2 2 2 19 2 2 2 2 2 2 19 19 2 2 19 2 2 2 2 2 19 2 2 2 20 26 21 21 21 21 
21 21 21 21 21 27 20 19 19 19 19 19 19 19 19 19 19 19 19 19 2 2 2 19 2 2 19 19 19 2 2 19 19 19 19 19 2 19 19 19 19 2 19 2 20 26 21 21 21 21 
21 21 21 21 21 27 20 19 19 19 19 19 19 19 19 19 19 19 19 19 2 2 2 19 2 19 19 2 19 19 2 2 2 2 2 2 2 19 2 2 19 2 19 2 20 26 21 21 21 21 
21 21 21 21 21 27 20 19 19 19 19 19 19 19 19 19 19 19 19 19 2 2 2 19 2 19 2 2 2 19 19 19 19 2 19 19 19 19 19 2 19 2 2 2 20 26 21 21 21 21 
21 21 21 21 21 27 20 19 19 19 19 19 19 19 19 19 2 2 2 2 2 2 2 19 2 2 19 19 2 19 2 2 19 2 2 2 2 19 19 2 19 19 19 2 20 26 21 21 21 21 
21 21 21 21 21 27 20 19 19 19 19 19 19 19 19 19 2 2 2 2 2 2 2 19 19 3 2 2 2 2 2 2 2 2 19 19 19 2 2 2 2 19 2 2 20 26 21 21 21 21 
21 21 21 21 21 27 20 19 19 19 19 19 19 19 19 19 2 2 2 2 2 2 2 2 19 19 19 19 19 19 19 19 19 2 2 2 2 2 19 2 19 19 19 2 20 26 21 21 21 21 
21 21 21 21 21 27 20 19 19 19 19 19 19 19 19 19 2 2 2 2 2 2 2 2 19 20 20 20 20 20 20 20 19 19 19 19 19 19 19 2 2 2 2 2 20 26 21 21 21 21 
21 21 21 21 21 27 20 19 19 19 19 19 19 19 19 19 2 2 2 2 2 2 2 2 19 20 5 9 4 10 5 20 19 2 2 2 2 19 19 2 19 19 2 2 20 26 21 21 21 21 
21 21 21 21 21 27 20 19 19 19 19 19 19 19 19 19 2 2 2 2 2 2 2 2 19 20 5 9 2 10 5 20 19 2 19 19 2 2 2 2 2 2 2 2 20 26 21 21 21 21 
21 21 21 21 21 27 20 19 19 19 19 19 19 19 19 2 2 2 2 2 2 2 2 2 19 20 5 11 12 13 5 20 19 2 2 2 2 2 19 2 19 19 2 19 20 26 21 21 21 21 
21 21 21 21 21 27 20 19 19 19 19 19 19 19 19 2 2 2 2 2 2 2 2 2 19 20 5 5 5 5 5 20 19 2 19 2 19 19 19 2 2 19 2 19 20 26 21 21 21 21 
21 21 21 21 21 27 20 19 19 19 19 19 19 19 19 19 2 2 2 2 2 2 2 2 19 20 20 20 2 20 20 20 19 2 19 2 19 2 19 19 2 19 2 2 20 26 21 21 21 21 
21 21 21 21 21 27 20 19 19 19 19 19 19 19 19 19 2 2 2 2 2 2 2 2 19 19 19 19 2 19 19 19 19 2 19 2 19 2 2 19 2 19 2 19 20 26 21 21 21 21 
21 21 21 21 21 27 20 19 19 19 19 19 19 19 19 19 19 19 19 19 19 19 2 2 2 2 2 2 2 2 2 2 2 2 2 2 19 2 2 2 2 19 2 2 20 26 21 21 21 21 
21 21 21 21 21 27 20 20 20 20 20 20 20 20 20 20 20 20 20 20 20 20 20 20 20 20 20 20 20 20 20 20 20 20 20 20 20 20 20 20 20 20 20 20 20 26 21 21 21 21 
21 21 21 21 21 33 24 24 24 24 24 24 24 24 24 24 24 24 24 24 24 24 24 24 24 24 24 24 24 24 24 24 24 24 24 24 24 24 24 24 24 24 24 24 24 34 21 21 21 21 
21 21 21 21 21 21 21 21 21 21 21 21 21 21 21 21 21 21 21 21 21 21 21 21 21 21 21 21 22 22 21 21 21 21 21 21 21 21 21 21 21 21 21 21 21 21 21 21 21 21 
21 21 21 21 21 21 21 21 21 21 21 21 21 21 21 21 21 21 21 21 22 21 21 21 21 21 21 21 21 22 21 21 21 22 21 21 21 21 21 21 21 21 21 21 21 21 21 21 21 21 
21 21 21 21 21 21 21 21 21 21 21 21 21 21 21 21 21 21 21 21 21 21 21 21 21 21 21 22 21 22 21 21 21 21 21 21 21 21 21 21 21 21 21 21 21 21 21 21 21 21 
21 21 21 21 21 21 21 21 21 21 21 21 21 21 21 21 21 21 21 21 21 21 21 21 21 21 21 21 21 21 21 21 21 21 21 21 21 21 21 21 21 21 21 21 21 21 21 21 21 21 
21 21 21 21 21 21 21 21 21 21 21 21 21 21 21 21 21 21 21 21 21 21 21 21 21 21 21 21 21 21 21 21 21 21 21 21 21 21 21 21 21 21 21 21 21 21 21 21 21 21 
21 21 21 21 21 21 21 21 21 21 21 21 21 21 21 21 21 21 21 21 21 21 21 21 21 21 21 21 21 21 21 21 21 21 21 21 21 21 21 21 21 21 21 21 21 21 21 21 21 21 
21 21 21 21 21 21 21 21 21 21 21 21 21 21 21 21 21 21 21 21 21 21 21 21 21 21 21 21 21 21 21 21 21 21 21 21 21 21 21 21 21 21 21 21 21 21 21 21 21 21 
21 21 21 21 21 21 21 21 21 21 21 21 21 21 21 21 21 21 21 21 21 21 21 21 21 21 21 21 21 21 21 21 21 21 21 21 21 21 21 21 21 21 21 21 21 21 21 21 21 21 
21 21 21 21 21 21 21 21 21 21 21 21 21 21 21 21 21 21 21 21 21 21 21 21 21 21 21 21 21 21 21 21 21 21 21 21 21 21 21 21 21 21 21 21 21 21 21 21 21 21 
21 21 21 21 21 21 21 21 21 21 21 21 21 21 21 21 21 21 21 21 21 21 21 21 21 21 21 21 21 21 21 21 21 21 21 21 21 21 21 21 21 21 21 21 21 21 21 21 21 21 
21 21 21 21 21 21 21 21 21 21 21 21 21 21 21 21 21 21 21 21 21 21 21 21 21 21 21 21 21 21 21 21 21 21 21 21 21 21 21 21 21 21 21 21 21 21 21 21 21 21 
21 21 21 21 21 21 21 21 21 21 21 21 21 21 21 21 21 21 21 21 21 21 21 21 21 21 21 21 21 21 21 21 21 21 21 21 21 21 21 21 21 21 21 21 21 21 21 21 21 21 
21 21 21 21 21 21 21 21 21 21 21 21 21 21 21 21 21 21 21 21 21 21 21 21 21 21 21 21 21 21 21 21 21 21 21 21 21 21 21 21 21 21 21 21 21 21 21 21 21 21 
21 21 21 21 21 21 21 21 21 21 21 21 21 21 21 21 21 21 21 21 21 21 21 21 21 21 21 21 21 21 21 21 21 21 21 21 21 21 21 21 21 21 21 21 21 21 21 21 21 21 
21 21 21 21 21 21 21 21 21 21 21 21 21 21 21 21 21 21 21 21 21 21 21 21 21 21 21 21 21 21 21 21 21 21 21 21 21 21 21 21 21 21 21 21 21 21 21 21 21 21 
21 21 21 21 21 21 21 21 21 21 21 21 21 21 21 21 21 21 21 21 21 21 21 21 21 21 21 21 21 21 21 21 21 21 21 21 21 21 21 21 21 21 21 21 21 21 21 21 21 21 
21 21 21 21 21 21 21 21 21 21 21 21 21 21 21 21 21 21 21 21 21 21 21 21 21 21 21 21 21 21 21 21 21 21 21 21 21 21 21 21 21 21 21 21 21 21 21 21 21 21 
21 21 21 21 21 21 21 21 21 21 21 21 21 21 21 21 21 21 21 21 21 21 21 21 21 21 21 21 21 21 21 21 21 21 21 21 21 21 21 21 21 21 21 21 21 21 21 21 21 21 
21 21 21 21 21 21 21 21 21 21 21 21 21 21 21 21 21 21 21 21 21 21 21 21 21 21 21 21 21 21 21 21 21 21 21 21 21 21 21 21 21 21 21 21 21 21 21 21 21 21 
21 21 21 21 21 21 21 21 21 21 21 21 21 21 21 21 21 21 21 21 21 21 21 21 21 21 21 21 21 21 21 21 21 21 21 21 21 21 21 21 21 21 21 21 21 21 21 21 21 21 
21 21 21 21 21 21 21 21 21 21 21 21 21 21 21 21 21 21 21 21 21 21 21 21 21 21 21 21 21 21 21 21 21 21 21 21 21 21 21 21 21 21 21 21 21 21 21 21 21 21 
