21 21 21 21 21 21 21 21 21 21 21 21 21 21 21 22 21 21 21 21 21 21 1 1 1 21 22 21 21 22 21 21 21 21 22 21 21 21 21 21 21 21 21 21 21 21 21 21 21 21 
21 21 21 21 21 21 22 21 21 21 21 21 21 22 21 21 22 21 21 21 21 21 1 1 1 21 21 21 21 22 21 21 21 21 21 21 22 21 21 21 21 22 21 21 21 22 21 21 21 21 
21 21 21 21 21 31 29 29 29 29 29 29 29 29 29 29 29 29 29 29 29 29 1 1 1 29 29 29 29 29 29 29 29 29 29 29 29 29 29 29 29 29 29 29 29 32 21 22 21 21 
21 21 21 22 21 27 20 20 20 20 20 20 20 20 20 20 20 20 20 20 20 20 2 2 2 20 20 20 20 20 20 20 20 20 20 20 20 20 20 20 20 20 20 20 20 26 21 21 21 21 
21 21 21 21 21 27 20 2 2 2 2 2 2 2 2 2 2 2 2 2 2 20 2 2 2 20 2 2 2 2 2 2 2 2 2 2 2 2 2 2 2 2 2 2 20 26 22 21 21 21 
21 22 21 21 21 27 20 2 2 2 2 2 2 2 2 2 2 2 2 2 2 20 2 2 2 20 2 2 2 2 2 2 2 2 2 2 2 2 3 2 2 2 2 2 20 26 21 21 21 21 
21 21 21 21 21 27 20 2 2 2 2 2 2 2 2 2 2 2 41 42 43 2 2 2 2 41 42 43 41 42 43 41 42 43 41 42 43 2 2 3 3 3 2 2 20 26 21 21 21 21 
21 21 21 21 21 27 20 2 2 2 2 2 2 2 2 2 2 2 39 38 40 2 2 2 2 39 38 40 39 38 40 39 38 40 39 38 40 2 2 2 2 2 2 2 20 26 21 22 21 21 
21 21 22 21 21 27 20 2 2 2 2 2 2 2 2 2 2 2 35 36 37 2 2 2 2 35 36 37 35 36 37 35 36 37 35 36 37 2 2 2 2 3 2 2 20 26 21 22 21 21 
21 21 21 21 21 27 20 2 2 2 2 2 2 2 2 2 2 2 41 42 43 2 2 2 2 2 2 2 2 2 2 2 2 2 2 2 2 2 2 2 2 2 2 2 20 26 21 21 21 21 
21 21 21 21 22 27 20 2 2 2 2 2 2 2 2 2 2 2 39 38 40 2 2 2 2 3 3 3 3 3 2 2 2 2 2 2 2 2 2 2 2 3 2 2 20 26 21 21 21 21 
21 21 21 21 21 27 20 2 2 2 2 2 2 2 2 2 2 2 35 36 37 2 2 2 3 2 2 2 2 2 2 2 2 2 2 2 2 2 2 3 2 3 2 2 20 26 21 21 21 21 
21 21 21 21 21 27 20 2 2 2 2 2 2 2 2 2 2 2 41 42 43 2 2 2 3 3 3 2 2 2 2 2 2 2 2 2 41 42 43 2 2 2 2 2 20 26 21 21 22 21 
21 21 21 21 21 27 20 2 2 2 2 2 2 2 2 2 2 2 39 38 40 2 2 2 2 2 2 3 3 3 3 3 3 2 2 2 39 38 40 2 2 2 2 2 20 26 21 21 21 21 
21 21 22 21 21 27 20 2 2 2 2 2 2 2 2 2 2 2 35 36 37 2 2 2 2 2 2 2 2 2 2 3 2 2 2 2 35 36 37 2 2 3 2 2 20 26 22 21 21 21 
21 21 21 21 21 27 20 2 2 2 2 2 2 2 2 2 2 2 41 42 43 2 2 3 3 3 2 3 2 2 2 2 2 2 2 2 41 42 43 2 2 2 2 2 20 26 21 21 21 21 
21 21 21 22 21 27 20 2 2 2 2 2 2 2 2 2 2 2 39 38 40 2 2 2 2 2 2 2 2 2 2 2 3 2 2 2 39 38 40 2 2 2 2 2 20 26 21 22 21 21 
21 21 21 21 21 27 20 2 2 2 2 2 2 2 2 2 2 2 35 36 37 2 2 2 2 2 2 2 2 2 2 2 2 2 2 2 35 36 37 2 2 2 2 2 20 26 21 21 21 21 
21 21 21 22 21 27 20 2 2 2 2 2 2 2 2 2 2 2 41 42 43 2 2 3 2 2 2 2 2 2 2 2 2 2 2 2 41 42 43 2 2 2 2 2 20 26 21 21 21 21 
21 21 21 21 21 27 20 2 2 2 2 2 2 2 2 2 2 2 39 38 40 2 2 2 2 20 20 20 20 20 20 20 2 3 2 2 39 38 40 2 3 2 2 2 20 26 21 21 21 21 
21 21 21 21 21 27 20 2 2 2 2 2 2 2 2 2 2 2 35 36 37 2 2 2 2 20 5 9 4 10 5 20 2 2 2 3 35 36 37 2 2 3 2 2 20 26 21 21 21 21 
21 21 21 21 21 27 20 2 2 2 2 2 2 2 2 2 2 2 41 42 43 2 2 2 2 20 5 9 2 10 5 20 2 2 2 2 41 42 43 2 2 2 2 2 20 26 21 22 21 21 
21 21 21 22 21 27 20 2 2 2 2 2 2 2 2 2 2 2 39 38 40 2 3 2 2 20 5 11 12 13 5 20 2 2 2 2 39 38 40 2 3 2 2 2 20 26 21 21 21 21 
21 21 21 21 21 27 20 2 2 2 2 2 2 2 2 2 2 2 35 36 37 2 2 2 2 20 5 5 5 5 5 20 2 3 2 2 35 36 37 2 2 2 2 2 20 26 21 21 21 21 
21 21 21 21 21 27 20 2 2 2 2 2 2 2 2 2 2 2 41 42 43 2 2 2 2 20 20 20 2 20 20 20 20 20 20 20 41 42 43 2 3 2 2 2 20 26 21 21 21 21 
21 21 21 21 21 27 20 2 2 2 2 2 2 2 2 2 2 2 39 38 40 2 3 2 3 2 2 2 2 2 2 2 2 2 2 20 39 38 40 2 2 2 2 3 20 26 21 21 21 21 
21 21 21 22 21 27 20 2 2 2 2 2 2 2 2 2 2 2 35 36 37 2 2 2 2 2 2 2 2 2 2 2 2 20 20 20 35 36 37 2 3 2 2 2 20 26 22 21 21 21 
21 21 21 21 21 27 20 20 20 20 20 20 20 20 20 20 20 20 20 20 20 20 20 20 20 20 20 20 20 20 20 20 20 20 20 20 20 20 20 20 20 20 20 20 20 26 21 21 21 21 
21 21 21 21 21 33 24 24 24 24 24 24 24 24 24 24 24 24 24 24 24 24 24 24 24 24 24 24 24 24 24 24 24 24 24 24 24 24 24 24 24 24 24 24 24 34 21 21 21 21 
21 21 21 21 21 21 21 21 21 21 21 21 21 21 21 21 21 21 21 21 21 21 21 21 21 21 21 21 22 22 21 21 21 21 21 21 21 21 21 21 21 21 21 21 21 21 22 21 21 21 
21 21 21 21 21 22 21 21 21 22 21 21 21 21 21 22 21 21 21 21 22 21 21 21 21 21 21 21 21 22 21 21 21 22 21 21 21 21 22 21 21 21 21 21 21 22 21 21 21 21 
21 21 21 21 21 21 21 21 21 21 21 21 21 21 21 21 21 21 21 21 21 21 21 21 21 21 21 22 21 22 21 21 21 21 21 21 21 21 21 21 21 22 21 21 21 21 21 21 21 21 
21 21 21 21 21 21 21 21 21 21 21 22 21 21 21 21 21 21 21 22 21 21 21 21 21 21 21 21 21 21 21 21 21 21 21 21 21 21 21 21 21 21 21 21 21 21 21 21 21 21 
21 21 21 21 21 21 21 21 21 21 21 21 21 21 21 21 21 21 21 21 21 21 21 21 21 21 21 21 21 21 21 21 21 21 21 21 21 21 21 21 21 21 21 21 21 21 21 21 21 21 
21 21 21 21 21 21 21 21 21 21 21 21 21 21 21 21 21 21 21 21 21 21 21 21 21 21 21 21 21 21 21 21 21 21 21 21 21 21 21 21 21 21 21 21 21 21 21 21 21 21 
21 21 21 21 21 21 21 21 21 21 21 21 21 21 21 21 21 21 21 21 21 21 21 21 21 21 21 21 21 21 21 21 21 21 21 21 21 21 21 21 21 21 21 21 21 21 21 21 21 21 
21 21 21 21 21 21 21 21 21 21 21 21 21 21 21 21 21 21 21 21 21 21 21 21 21 21 21 21 21 21 21 21 21 21 21 21 21 21 21 21 21 21 21 21 21 21 21 21 21 21 
21 21 21 21 21 21 21 21 21 21 21 21 21 21 21 21 21 21 21 21 21 21 21 21 21 21 21 21 21 21 21 21 21 21 21 21 21 21 21 21 21 21 21 21 21 21 21 21 21 21 
21 21 21 21 21 21 21 21 21 21 21 21 21 21 21 21 21 21 21 21 21 21 21 21 21 21 21 21 21 21 21 21 21 21 21 21 21 21 21 21 21 21 21 21 21 21 21 21 21 21 
21 21 21 21 21 21 21 21 21 21 21 21 21 21 21 21 21 21 21 21 21 21 21 21 21 21 21 21 21 21 21 21 21 21 21 21 21 21 21 21 21 21 21 21 21 21 21 21 21 21 
21 21 21 21 21 21 21 21 21 21 21 21 21 21 21 21 21 21 21 21 21 21 21 21 21 21 21 21 21 21 21 21 21 21 21 21 21 21 21 21 21 21 21 21 21 21 21 21 21 21 
21 21 21 21 21 21 21 21 21 21 21 21 21 21 21 21 21 21 21 21 21 21 21 21 21 21 21 21 21 21 21 21 21 21 21 21 21 21 21 21 21 21 21 21 21 21 21 21 21 21 
21 21 21 21 21 21 21 21 21 21 21 21 21 21 21 21 21 21 21 21 21 21 21 21 21 21 21 21 21 21 21 21 21 21 21 21 21 21 21 21 21 21 21 21 21 21 21 21 21 21 
21 21 21 21 21 21 21 21 21 21 21 21 21 21 21 21 21 21 21 21 21 21 21 21 21 21 21 21 21 21 21 21 21 21 21 21 21 21 21 21 21 21 21 21 21 21 21 21 21 21 
21 21 21 21 21 21 21 21 21 21 21 21 21 21 21 21 21 21 21 21 21 21 21 21 21 21 21 21 21 21 21 21 21 21 21 21 21 21 21 21 21 21 21 21 21 21 21 21 21 21 
21 21 21 21 21 21 21 21 21 21 21 21 21 21 21 21 21 21 21 21 21 21 21 21 21 21 21 21 21 21 21 21 21 21 21 21 21 21 21 21 21 21 21 21 21 21 21 21 21 21 
21 21 21 21 21 21 21 21 21 21 21 21 21 21 21 21 21 21 21 21 21 21 21 21 21 21 21 21 21 21 21 21 21 21 21 21 21 21 21 21 21 21 21 21 21 21 21 21 21 21 
21 21 21 21 21 21 21 21 21 21 21 21 21 21 21 21 21 21 21 21 21 21 21 21 21 21 21 21 21 21 21 21 21 21 21 21 21 21 21 21 21 21 21 21 21 21 21 21 21 21 
21 21 21 21 21 21 21 21 21 21 21 21 21 21 21 21 21 21 21 21 21 21 21 21 21 21 21 21 21 21 21 21 21 21 21 21 21 21 21 21 21 21 21 21 21 21 21 21 21 21 
21 21 21 21 21 21 21 21 21 21 21 21 21 21 21 21 21 21 21 21 21 21 21 21 21 21 21 21 21 21 21 21 21 21 21 21 21 21 21 21 21 21 21 21 21 21 21 21 21 21 
