21 21 21 21 21 21 21 21 21 21 21 21 21 21 21 21 21 21 21 21 21 21 21 21 21 21 21 21 21 21 21 21 21 21 21 21 21 21 21 21 21 21 21 21 21 21 21 21 21 21 
21 21 21 21 21 21 21 21 21 21 21 21 21 21 21 21 21 21 21 21 21 21 21 21 21 21 21 21 21 21 21 21 21 21 21 21 21 21 21 21 21 21 21 21 21 21 21 21 21 21 
21 21 21 21 21 21 21 21 21 21 21 21 21 21 21 21 21 21 21 21 21 21 21 21 21 21 21 21 21 21 21 21 21 21 21 21 21 21 21 21 21 21 21 21 21 21 21 21 21 21 
21 21 21 21 21 21 21 21 21 21 21 21 21 21 21 21 21 21 21 21 21 21 21 21 21 21 21 21 21 21 21 21 21 21 21 21 21 21 21 21 21 21 21 21 21 21 21 21 21 21 
21 21 21 21 21 21 21 21 21 31 29 29 29 29 29 29 29 29 29 29 29 29 29 29 29 29 29 29 29 29 29 29 29 29 29 29 29 29 29 29 29 29 29 29 29 29 29 29 29 29 
21 21 21 21 21 21 21 21 21 27 19 2 2 2 2 2 2 2 2 2 2 2 20 20 20 20 20 20 20 20 20 20 20 20 20 2 3 3 2 2 2 2 2 2 2 2 2 3 2 2 
21 21 21 21 21 21 21 21 21 27 19 10 5 5 5 9 2 2 2 45 2 2 20 20 20 20 20 20 20 20 20 20 20 20 20 2 2 2 3 2 45 3 2 2 45 2 2 2 45 3 
21 21 21 21 21 21 21 21 21 27 19 10 5 5 5 9 2 2 2 44 3 3 20 45 2 2 2 2 4 2 2 2 2 45 20 2 2 2 3 2 44 2 3 3 44 2 2 3 44 2 
21 21 21 21 21 21 21 21 21 27 19 10 5 5 5 9 3 2 2 2 2 2 20 44 2 2 2 2 2 2 2 2 2 44 20 2 3 2 14 12 12 12 12 12 12 12 12 12 12 12 
21 21 21 21 21 21 21 21 21 27 19 10 5 5 5 9 41 42 43 2 2 2 20 2 2 23 24 24 24 24 24 25 2 2 20 2 3 45 10 5 5 5 5 5 5 5 5 5 5 5 
21 21 21 21 21 21 21 21 21 27 19 10 5 5 5 9 39 38 40 2 2 2 20 2 23 34 21 21 21 21 21 33 25 2 20 2 3 44 10 5 5 5 5 5 5 5 5 5 5 5 
21 21 21 21 21 21 21 21 21 27 19 10 5 5 5 9 35 36 37 2 2 2 20 2 28 32 21 21 21 21 21 31 30 2 20 2 3 2 10 5 5 5 5 5 5 5 5 5 5 5 
21 21 21 21 21 21 21 21 21 27 19 10 5 5 5 9 2 2 2 3 2 2 20 2 2 28 29 29 29 29 29 30 2 2 20 3 3 2 10 5 5 5 6 7 7 7 7 7 7 7 
21 21 21 21 21 21 21 21 21 27 19 10 5 5 5 9 2 45 2 2 2 2 20 2 2 2 2 2 2 2 2 2 2 2 20 2 2 2 10 5 5 5 9 2 2 41 42 43 2 2 
21 21 21 21 21 21 21 21 21 27 19 10 5 5 5 9 2 44 3 2 2 2 20 20 20 20 20 20 3 20 20 20 20 20 20 2 2 2 10 5 5 5 9 3 2 39 38 40 2 2 
21 21 21 21 21 21 21 21 21 27 19 10 5 5 5 9 2 2 2 2 2 2 2 3 2 2 2 2 2 2 2 3 2 2 2 2 2 45 10 5 5 5 9 2 3 35 36 37 2 2 
21 21 21 21 21 21 21 21 21 27 19 10 5 5 5 11 12 12 12 12 12 12 12 12 12 12 12 12 3 2 2 3 2 2 2 2 2 44 10 5 5 5 9 2 2 2 2 3 2 2 
21 21 21 21 21 21 21 21 21 27 19 10 5 5 5 5 5 5 5 5 5 5 5 5 5 5 5 5 9 2 2 45 2 2 2 3 3 2 10 5 5 5 9 2 2 2 2 3 2 2 
21 21 21 21 21 21 21 21 21 27 19 10 5 5 5 5 5 5 5 5 5 5 5 5 5 5 5 5 11 15 2 44 2 2 2 3 2 2 10 5 5 5 9 2 3 2 2 2 2 2 
21 21 21 21 21 21 21 21 21 27 19 10 5 5 5 5 5 5 5 5 5 5 5 5 5 5 5 5 5 9 2 3 41 42 43 2 2 2 10 5 5 5 9 2 48 49 2 2 45 2 
21 21 21 21 21 21 21 21 21 27 19 2 7 7 7 7 7 7 7 7 7 7 7 7 7 8 5 5 5 9 2 2 39 38 40 2 2 2 10 5 5 5 9 2 46 47 3 2 44 2 
21 21 21 21 21 21 21 21 21 27 19 2 3 3 2 2 2 2 2 2 2 2 2 48 49 10 5 5 5 9 2 3 35 36 37 2 3 2 10 5 5 5 9 2 2 2 2 2 3 2 
21 21 21 21 21 21 21 21 21 27 19 2 2 45 2 2 3 3 2 3 3 2 2 46 47 10 5 5 5 11 12 12 12 12 12 12 12 12 13 5 5 5 9 2 3 2 2 2 2 2 
21 21 21 21 21 21 21 21 21 27 19 2 3 44 2 2 3 2 2 2 2 2 2 2 2 10 5 5 5 5 5 5 5 5 5 5 5 5 5 5 5 5 9 2 2 2 45 2 2 2 
21 21 21 21 21 21 21 21 21 27 19 2 2 2 2 2 2 2 2 3 2 2 2 2 2 10 5 5 5 5 5 5 5 5 5 5 5 5 5 5 5 5 9 2 2 2 44 2 2 2 
21 21 21 21 21 21 21 21 21 27 19 2 48 49 2 2 3 2 2 2 2 2 2 45 2 10 5 5 5 5 5 5 5 5 5 5 5 5 5 5 5 5 9 2 2 2 3 2 2 2 
21 21 21 21 21 21 21 21 21 27 19 2 46 47 2 2 2 2 2 2 2 2 2 44 2 10 5 5 5 6 7 7 8 5 5 5 5 6 7 7 7 7 17 2 3 2 2 2 2 2 
21 21 21 21 21 21 21 21 21 27 19 2 2 12 12 12 12 12 12 12 12 12 12 12 12 13 5 5 5 9 2 45 10 5 5 5 5 9 41 42 43 2 2 20 20 20 2 20 20 20 
21 21 21 21 21 21 21 21 21 27 19 2 13 5 5 5 5 5 5 5 5 5 5 5 5 5 5 5 5 9 3 44 10 5 5 5 5 9 39 38 40 2 2 20 1 1 1 1 1 20 
21 21 21 21 21 21 21 21 21 27 19 10 5 5 5 5 5 5 5 5 5 5 5 5 5 5 5 5 5 9 2 2 10 5 5 5 5 9 35 36 37 3 3 20 1 1 1 1 1 20 
21 21 21 21 21 21 21 21 21 27 19 10 5 5 5 5 5 5 5 5 5 5 5 5 5 5 5 6 7 17 3 2 10 5 5 5 5 9 2 3 2 2 2 20 1 1 1 1 1 20 
21 21 21 21 21 21 21 21 21 27 19 10 5 5 5 6 7 7 7 7 7 7 7 7 7 7 7 17 2 2 3 3 10 5 5 5 5 9 2 2 2 2 2 20 1 1 1 1 1 20 
21 21 21 21 21 21 21 21 21 27 19 10 5 5 5 9 2 2 41 42 43 3 2 2 2 3 2 2 2 14 12 12 13 5 5 5 5 11 12 12 15 2 3 20 1 1 1 1 1 20 
21 21 21 21 21 21 21 21 21 27 19 10 5 5 5 9 3 3 39 38 40 2 2 3 45 2 2 2 14 13 5 5 5 5 5 5 5 5 5 5 11 15 2 20 1 1 18 1 1 20 
21 21 21 21 21 21 21 21 21 27 19 10 5 5 5 9 2 3 35 36 37 3 3 2 44 2 3 14 13 5 5 5 5 5 5 5 5 5 5 5 5 11 15 20 20 20 20 20 20 20 
21 21 21 21 21 21 21 21 21 27 19 10 5 5 5 9 2 2 2 2 2 2 2 3 3 2 14 13 5 5 5 5 6 7 7 7 7 8 5 5 5 5 11 15 2 2 2 3 2 3 
21 21 21 21 21 21 21 21 21 27 19 10 5 5 5 9 3 2 2 2 2 3 3 3 2 14 13 5 5 5 5 6 17 41 42 42 43 16 8 5 5 5 5 11 15 2 2 3 45 2 
21 21 21 21 21 21 21 21 21 27 19 10 5 5 5 9 2 45 3 2 2 2 2 2 14 13 5 5 5 5 6 17 3 39 38 38 40 3 16 8 5 5 5 5 11 15 3 2 44 2 
21 21 21 21 21 21 21 21 21 27 19 10 5 5 5 9 3 44 3 3 2 2 14 12 13 5 5 5 5 6 17 2 2 35 36 36 37 2 2 16 8 5 5 5 5 11 12 15 2 2 
21 21 21 21 21 21 21 21 21 27 19 10 5 5 5 9 3 2 3 2 2 2 13 5 5 5 5 5 6 17 2 45 2 2 3 2 2 2 48 49 16 8 5 5 5 5 5 11 15 2 
21 21 21 21 21 21 21 21 21 27 19 10 5 5 5 9 2 3 2 2 2 10 5 5 5 5 5 6 17 2 3 44 3 2 3 2 2 2 46 47 3 16 8 5 5 5 5 5 9 3 
21 21 21 21 21 21 21 21 21 27 19 16 7 7 7 17 2 2 2 2 2 16 7 7 7 7 7 17 2 2 2 2 2 3 3 2 2 2 2 2 2 2 2 7 7 7 7 7 17 2 
21 21 21 21 21 21 21 21 21 33 24 24 24 24 24 24 24 24 24 24 24 24 24 24 24 24 24 24 24 24 24 24 24 24 24 24 24 24 24 24 24 24 24 24 24 24 24 24 24 24 
21 21 21 21 21 21 21 21 21 21 21 21 21 21 21 21 21 21 21 21 21 21 21 21 21 21 21 21 21 21 21 21 21 21 21 21 21 21 21 21 21 21 21 21 21 21 21 21 21 21 
21 21 21 21 21 21 21 21 21 21 21 21 21 21 21 21 21 21 21 21 21 21 21 21 21 21 21 21 21 21 21 21 21 21 21 21 21 21 21 21 21 21 21 21 21 21 21 21 21 21 
21 21 21 21 21 21 21 21 21 21 21 21 21 21 21 21 21 21 21 21 21 21 21 21 21 21 21 21 21 21 21 21 21 21 21 21 21 21 21 21 21 21 21 21 21 21 21 21 21 21 
21 21 21 21 21 21 21 21 21 21 21 21 21 21 21 21 21 21 21 21 21 21 21 21 21 21 21 21 21 21 21 21 21 21 21 21 21 21 21 21 21 21 21 21 21 21 21 21 21 21 
21 21 21 21 21 21 21 21 21 21 21 21 21 21 21 21 21 21 21 21 21 21 21 21 21 21 21 21 21 21 21 21 21 21 21 21 21 21 21 21 21 21 21 21 21 21 21 21 21 21 
21 21 21 21 21 21 21 21 21 21 21 21 21 21 21 21 21 21 21 21 21 21 21 21 21 21 21 21 21 21 21 21 21 21 21 21 21 21 21 21 21 21 21 21 21 21 21 21 21 21 
21 21 21 21 21 21 21 21 21 21 21 21 21 21 21 21 21 21 21 21 21 21 21 21 21 21 21 21 21 21 21 21 21 21 21 21 21 21 21 21 21 21 21 21 21 21 21 21 21 21 
