21 21 21 21 21 21 21 21 21 21 21 21 21 21 21 21 21 21 21 21 21 21 21 21 21 21 21 21 21 21 21 21 21 21 21 21 21 21 21 21 21 21 21 21 21 21 21 21 21 21 
21 21 21 21 21 21 21 21 21 21 21 21 21 21 22 21 21 21 21 21 21 21 21 21 21 21 21 21 21 21 21 21 21 21 21 21 21 21 21 21 21 21 21 21 21 21 21 21 21 21 
21 21 21 21 21 21 21 22 21 21 21 21 21 21 21 21 21 21 21 21 21 21 21 21 21 22 21 21 21 21 21 21 21 22 21 21 21 21 21 21 21 21 21 21 21 21 21 21 21 21 
21 21 21 21 22 21 21 21 21 21 21 22 21 21 21 21 21 21 22 21 21 21 21 21 21 21 21 22 21 21 21 21 21 21 21 21 21 21 21 21 21 22 21 21 21 21 21 21 21 21 
21 21 21 21 21 21 21 21 21 22 21 21 21 21 21 22 21 21 21 21 21 21 21 22 21 21 21 21 21 21 21 22 21 21 22 21 21 21 22 21 21 21 21 21 21 21 21 21 21 21 
21 21 21 21 21 21 21 21 21 21 21 21 21 21 21 21 21 21 21 21 21 22 21 21 21 21 21 21 21 22 21 21 21 21 21 21 22 21 21 21 21 21 21 22 21 21 21 21 21 21 
21 21 21 21 21 22 31 29 29 29 29 29 29 29 32 21 21 21 31 29 29 29 29 29 29 29 29 32 21 21 21 31 29 29 29 29 29 29 29 29 29 29 32 21 21 21 21 21 21 21 
21 21 21 21 21 21 27 19 20 20 20 20 20 19 28 29 29 29 30 19 2 2 41 42 43 2 2 28 29 29 29 30 19 19 2 2 2 2 2 2 2 19 26 21 21 22 21 21 21 21 
21 21 22 21 21 21 27 19 20 0 4 0 20 19 19 19 19 19 19 19 2 2 39 38 40 2 2 19 19 19 19 19 19 19 2 2 2 2 2 2 2 19 26 21 21 21 21 21 21 21 
21 21 21 21 21 21 27 19 20 0 0 0 20 19 19 19 19 19 19 19 2 2 35 36 37 2 2 19 19 19 19 19 19 19 2 2 2 2 2 2 2 19 26 21 21 21 21 21 21 21 
21 21 21 22 21 21 27 19 20 0 0 0 20 19 19 19 19 19 19 19 2 2 2 2 2 2 2 19 19 19 19 19 19 19 2 2 2 2 2 2 2 19 26 21 22 21 21 21 21 21 
21 21 21 21 22 21 27 19 20 0 0 0 20 19 19 19 19 19 19 19 2 2 2 2 2 2 2 2 2 2 2 2 2 2 2 2 2 2 2 2 2 19 26 21 21 21 21 21 21 21 
21 21 21 21 21 21 27 19 20 20 0 20 20 19 19 19 19 19 19 19 2 2 2 2 2 2 2 19 19 19 19 19 19 19 19 19 19 50 2 19 19 19 26 22 21 21 21 21 21 21 
21 21 21 21 21 21 27 19 19 19 2 19 19 19 19 19 19 19 19 19 19 19 2 2 2 19 19 19 19 19 19 19 19 19 19 19 19 2 2 19 23 24 34 21 21 21 21 21 21 21 
21 21 21 21 22 21 27 19 19 19 2 19 19 19 19 19 19 19 19 19 19 19 2 2 2 19 19 19 19 19 19 19 19 19 19 19 19 2 50 19 26 21 21 21 21 22 21 21 21 21 
21 21 21 21 21 21 33 25 19 19 2 19 19 19 19 19 19 19 19 19 19 19 2 2 2 19 19 19 19 19 19 19 19 19 19 19 19 2 2 19 26 21 21 21 21 21 21 21 21 21 
21 21 21 21 21 21 21 33 25 19 2 19 19 19 19 19 19 19 19 19 19 19 2 2 2 19 19 19 19 19 19 19 19 19 19 19 19 50 2 19 26 21 21 21 21 21 22 21 21 21 
21 21 22 21 21 21 21 31 30 19 2 19 19 19 19 19 19 19 19 19 19 19 2 2 2 19 19 19 19 19 19 19 19 19 19 2 2 2 2 19 26 21 21 22 21 21 21 21 21 21 
21 21 21 21 21 21 21 27 2 2 2 19 19 19 19 19 19 19 19 19 19 19 2 2 2 19 19 19 19 19 19 19 19 19 19 2 2 2 2 19 26 21 21 21 21 21 21 21 21 21 
21 21 21 22 21 21 21 27 2 19 19 19 19 19 19 19 19 19 19 19 19 2 2 2 2 2 19 19 19 19 19 19 19 19 19 2 2 2 2 19 26 21 22 21 21 21 21 21 21 21 
21 21 21 21 21 21 21 27 2 19 19 19 2 2 2 2 2 2 2 2 2 2 2 45 2 2 2 2 2 2 2 2 2 2 2 2 2 2 2 19 26 21 21 21 21 21 21 21 21 21 
21 21 21 21 21 22 21 27 2 19 19 19 2 2 2 2 2 2 2 2 2 2 2 44 2 2 2 2 2 2 2 2 2 2 2 2 2 2 2 23 34 21 21 21 21 21 21 21 21 21 
21 21 21 21 21 21 22 27 2 2 19 19 2 2 2 2 2 2 2 2 2 2 2 2 2 2 2 2 2 2 2 2 2 2 2 2 2 2 2 26 21 22 21 21 21 21 21 21 21 21 
21 21 21 21 21 21 21 33 25 2 19 19 2 2 2 19 19 19 19 19 19 2 2 2 2 2 19 19 19 19 19 19 19 19 19 2 2 2 2 26 21 21 21 21 22 21 21 21 21 21 
21 21 21 21 21 21 21 21 27 2 19 19 2 2 2 19 19 19 19 19 19 19 2 2 2 19 19 19 19 19 19 19 19 19 19 2 2 2 2 26 21 21 21 21 21 21 21 21 21 21 
21 21 21 21 21 22 21 31 30 2 19 19 2 2 2 19 19 19 19 19 19 19 2 2 2 19 19 19 19 19 19 19 19 19 19 2 2 2 2 26 21 21 21 22 21 21 21 21 21 21 
21 21 21 21 21 21 21 27 2 2 19 19 19 19 2 19 19 19 19 19 19 19 2 2 2 19 19 19 19 19 19 19 19 19 19 2 2 2 2 26 21 21 21 21 21 21 21 21 21 21 
21 21 21 22 21 21 21 27 2 19 19 19 19 19 2 19 19 19 19 19 19 19 2 2 2 19 19 4 19 19 19 19 19 19 19 2 2 2 2 26 21 22 21 21 21 21 21 21 21 21 
21 21 21 21 21 21 21 27 2 19 19 19 19 19 2 19 19 19 19 19 19 19 2 2 2 19 19 19 19 19 4 19 19 19 19 2 2 2 2 26 21 21 21 21 21 21 21 21 21 21 
21 21 21 21 21 21 22 27 2 2 2 2 2 2 2 19 19 19 19 19 19 19 2 2 2 19 19 19 19 19 4 19 19 19 19 2 2 2 2 26 21 21 21 21 22 21 21 21 21 21 
21 21 21 21 21 21 21 27 2 2 2 2 2 2 2 19 19 19 19 19 19 19 2 2 2 19 19 19 19 19 19 19 19 19 19 19 2 19 23 34 21 21 22 21 21 21 21 21 21 21 
21 21 21 21 21 21 21 33 25 2 2 2 2 2 2 19 19 19 19 19 19 19 2 2 2 19 19 19 19 19 19 19 19 19 19 2 2 2 26 21 21 21 21 21 21 21 21 21 21 21 
21 21 21 21 21 22 21 21 27 2 2 2 2 2 2 19 19 19 19 19 19 19 2 2 2 19 19 19 19 19 19 19 19 19 19 2 2 2 26 21 21 21 21 21 21 21 22 21 21 21 
21 21 21 21 21 21 21 21 27 2 2 2 2 2 2 19 19 19 19 19 19 19 2 2 2 19 19 19 19 19 19 19 19 19 19 2 2 2 26 21 21 22 21 21 21 21 21 21 21 21 
21 21 21 21 21 21 21 21 27 2 2 2 2 2 2 19 19 19 19 19 19 19 2 2 2 19 19 19 19 19 19 19 19 19 19 2 2 2 28 32 21 21 21 21 21 21 21 21 21 21 
21 21 21 21 22 21 21 31 30 19 19 19 19 19 19 19 19 19 19 19 19 19 2 2 2 19 19 19 19 19 19 19 19 19 19 2 2 2 19 28 32 21 21 21 21 21 21 21 21 21 
21 21 21 21 21 21 21 27 19 19 19 19 19 19 19 19 19 19 19 2 2 2 2 2 2 2 2 19 19 19 19 19 19 19 2 2 2 2 2 19 26 21 21 21 22 21 21 21 21 21 
21 21 21 21 21 21 22 27 19 19 19 19 19 19 19 19 19 19 2 2 2 2 2 2 2 2 2 2 19 19 4 19 19 2 2 2 2 2 2 2 26 21 21 21 21 21 21 21 21 21 
21 21 21 21 21 21 21 27 4 19 19 19 19 19 19 19 19 19 2 2 2 2 48 49 2 2 2 2 19 19 19 19 2 2 2 2 2 2 2 2 26 21 22 21 21 21 21 21 21 21 
21 21 21 21 21 21 21 27 4 19 19 19 19 4 19 19 19 19 2 2 2 2 46 47 2 2 2 2 2 19 19 19 2 2 2 2 2 19 2 2 26 21 21 21 21 21 21 21 21 21 
21 21 22 21 21 21 21 27 4 19 19 19 19 19 19 19 19 19 2 2 2 2 2 2 2 2 2 2 2 2 2 2 2 2 19 2 2 2 2 2 26 21 21 21 21 22 21 21 21 21 
21 21 21 21 21 21 21 27 4 19 19 19 19 4 19 23 24 24 25 2 2 2 2 2 2 2 2 23 24 24 25 2 2 2 2 2 2 2 2 2 26 21 21 21 21 21 21 22 21 21 
21 21 21 21 21 21 21 27 19 19 19 19 19 19 23 34 21 21 33 25 2 2 2 2 2 2 23 34 21 21 27 2 2 19 2 2 19 2 2 2 26 21 21 21 21 21 21 21 21 21 
21 21 21 21 22 21 21 33 24 24 24 24 24 24 34 21 21 21 21 33 24 24 24 24 24 24 34 21 22 21 33 25 2 2 2 2 2 2 23 24 34 21 22 21 21 21 21 21 21 21 
21 21 21 21 21 21 21 21 21 21 21 21 21 21 21 21 21 21 22 21 21 21 21 21 21 21 21 21 21 21 21 33 24 24 24 24 24 24 34 21 21 21 21 21 21 21 22 21 21 21 
21 21 21 21 21 21 21 21 21 21 21 22 21 21 21 21 22 21 21 21 21 21 21 21 21 21 21 21 21 21 21 21 21 21 21 21 22 21 21 21 21 21 21 22 21 21 21 21 21 21 
21 21 21 21 21 21 22 21 21 21 21 21 21 21 21 21 21 21 21 21 21 21 21 21 22 21 21 21 21 22 21 21 21 21 21 21 21 21 21 21 21 21 21 21 21 21 21 21 21 21 
21 21 21 21 21 21 21 21 21 21 21 21 21 21 22 21 21 21 21 21 22 21 21 21 21 21 21 21 21 21 21 21 22 21 21 21 21 21 21 22 21 21 21 21 21 21 21 21 21 21 
21 21 21 21 21 21 21 21 21 21 21 21 21 21 21 21 21 21 21 21 21 21 21 21 21 21 21 22 21 21 21 21 21 21 21 21 21 21 21 21 21 21 21 21 21 22 21 21 21 21 
21 21 21 21 21 21 21 21 21 21 21 21 21 21 21 21 21 21 21 21 21 21 21 21 21 21 21 21 21 21 21 21 21 21 21 21 21 21 21 21 21 21 21 21 21 21 21 21 21 21 
